-------------------
-X-XXXXXXXXXXXXXXX-
----X-XXXX---X---X-
--X--------X---X---
-XXXXX-XXXXX-XXXXX-
-XXXXX-XXXXX-XXXXX-
-XXXXX-XXXXX-XXXXX-
-------------------
-X-XXXXXXXXXXXXXXX-
----X-XXXX---X---X-
--X--------X---X---
-XXXXX-XXXXX-XXXXX-
-XXXXX-XXXXX-XXXXX-
-XXXXX-XXXXX-XXXXX-
-------------------
-XXXXX-XXXXX-XXXXX-
-XXXXX-XXXXX-XXXXX-
-------------------
