XXXXXXXXXXXXXXXXXXXXXXXXXXX
XXXXX-----------------XXXXX
XXXXX-XXXXXXXXXXXXXXX-XXXXX
XXXXX-XXXXXXXXXXXXXXX-XXXXX
XXXXX-XXXXXXXXXXXXXXX-XXXXX
---------------------------
XXXXX-XXXXXXX-XXXXXXX-XXXXX
XXXXX-XXXXXXX-XXXXXXX-XXXXX
XXXXX-XXXXXXX-XXXXXXX-XXXXX
XXXXX-XXXXXXX-XXXXXXX-XXXXX
XXXXX-XXXXXXX-XXXXXXX-XXXXX
XXXXX-XXXXXXX-XXXXXXX-XXXXX
---------------------------
XXXXX-XXXXXXXXXXXXXXX-XXXXX
XXXXX-XXXXXXXXXXXXXXX-XXXXX
XXXXX-XXXXXXXXXXXXXXX-XXXXX
XXXXX-----------------XXXXX
XXXXXXXXXXXXXXXXXXXXXXXXXXX
